############################################################
############################################################
##                                                        ##
##                   J         #                          ##
##       ###                    #                         ##
##       #                       #                        ##
##       #                        #                       ##
##       #                         #                      ##
##       #                          #                     ##
##       #                           #                    ##
##       #                            ######################
##       #                            #                   ##
##       #                            #                   ##
##       #                                                  
##        #                                                 
##        #                           #                   ##
##         #                          #                   ##
##         #                          ######################
##          #                                             ##
##          #       I                                     ##
##           #                                            ##
##                                                        ##
##                ####################              ########
##                                                  #     ##
##                                                  #     ##
##                                                  #     ##
##                                                        ##
##                                                        ##
############################################################
############################################################
